1111111111111111
1001000010010001
1001011110010001
1001000000010001
1001111111010001
1000000000010001
1011111111010001
10000000000E0001
1000C0000000P001
1111111111111111