1111111111111111
1001000010010001
1001011110010001
1001000000010001
1001111111010001
1000000000010001
1011111111010001
1C0000000000E001
1000000000000001
1111111111111111

 