111111
100C01
10P0E1
100001
111111