1111111111111111
1001000010010001
1001011110010001
10010000C0010001
1001111111010001
1000000000010001
1011111111010001
100000C000000001
10000E00P0000001
1111111111111111

